Content-Type: text/x-zim-wiki
Wiki-Format: zim 0.6
Creation-Date: 2022-11-24T23:14:29+07:00

+ Nấm bào ngư : Nấm sò: nâu | trắng | xám : Nấm ngọc thạch (?) : Pleurotus ostreatus : Oyster Mushroom
+ Nấm nâu tây : brown oyster mushroom
+ Nấm hào hương : gray oyster mushroom
+ Nấm đùi gà : Pleurotus eryngii : King oyster mushroom
+ Nấm kim châm : Flammulina filiformis: Enokitake
+ Nấm hoàng kim : Nấm ngô: Pleurotus Citrinopilratus: golden oyster mushroom
+ Nấm ngọc châm : Nâu | Trắng : ypsizygus tessulatus : beech mushroom
+ Nấm hương : nấm đông cô : Lentinula edodes : shiitake mushroom
+ Nấm rơm :Volvariella volvacea: Straw mushroom
+ Nấm mỡ trắng - nâu: Agaricus bisporus : White button
+ Nấm tuyết (Nấm ngân nhĩ)
#### Dry: 
+ Nấm mèo: Mộc nhĩ : Auricularia cornea : cloud ear
+ Mộc nhĩ trắng: Tremella fuciformis : white cloud ears
+ Nấm Tùng Nhung : Tricholoma matsutake : Matsutake 
+ Nấm tràm: Tylopilus felleus : bitter bolete

#### Hiếm
+ Hắc mộc nhĩ : Auricularia heimuer : black wood ear
+ Kim nhĩ: Mộc nhĩ vàng : Naematelia aurantialba
+ 榆耳 : Gloeostereum incarnatum
+ Nấm sữa : Lactarius deliciosus : saffron milk cap 
+ Nấm bào ngư Nhật :  Pleurotus Cystidiosus : maple oyster mushroom
+ Nấm linh chi : Nâu (Brown crab mushroom) | Trắng
+ Nấm yến : Pleurotus Ostreatus
+ Nấm sò hồng : nấm hồng ngọc : Pleurotus djamor: 
+ Nấm Kim Phúc: Tricholoma giganteum
+ Nấm mối : Termitomyces albuminosus : termite mushroom
+ Nấm thông : Boletus edulis : penny bun
+ Nấm chân dài : Clitocybe Maxima : Big Cup Mushroom
+ Đông trùng hạ thảo :Cordyceps militaris: 
+ Nấm Hoàng Đế : Calocybe indica
+ Nấm trà tân : nấm trân châu : Agrocybe aegerita Sing
+ Nấm mối đen: Xerula radicata
+ Nấm sò hương


#### Rare - Medicinal
+ Nấm hầu thủ : Hericium erinaceus : Lion's mane
+ Nấm Thái dương : Agaricus brasiliensis :  sun mushroom
+ Nấm linh chi : reishi mushroom
+ Morchella
+ Nấm cục : Tuber 
+ Nấm tre : Phallus indusiatus : bamboo mushrooms

Refer:
+ [Nấm Trang Sinh](http://trangmush.com/)
+ [nongsandungha](https://nongsandungha.com/lien-he.html)
